TTTTTTTTTTTTTTTTTTTTTT
T    T              TT
T R  T              TT
T    T              TT
T                   TT
T                   TT
T    T              TT
T    T              TT
T    T              TT
T    T              TT
TTTTTTTTTTTTTTTTTTTTTT
TTTTTTTTTTTTTTTTTTTTTT